{
  "map": [
    "................",
    "....WWWWW.......",
    "....W...W.......",
    "....W...W.......",
    "....WWWWW.......",
    "................",
    "....~~~~~.......",
    "................"
  ]
}
