{
  "map": [
    "WWWWWWWWWWWWWWWWWWWWWWWWWWWW",
    "W..........................W",
    "W...WWWWWWW...........~....W",
    "W.........WWWWW.......~....W",
    "W.............W....~~~~....W",
    "W.............W....~.......W",
    "W.........WWWWW....~.......W",
    "W..................~.......W",
    "W.........~~~~~~~~~~.......W",
    "W..........................W",
    "W..........................W",
    "W..........~WWW............W",
    "W..........~~~~~~~.........W",
    "WWWWW............~~~.......W",
    "W..........................W",
    "W..........................W",
    "WWWWWWWWWWWWWWWWWWWWWWWWWWWW"
  ]
}
